##########################################################################
##::                                                                    ##
##    ################################################################  ##
##                                                                      ##
##                                                                      ##
##                                                                      ##
##                                                                      ##
##                                                                      ##
##                                                                      ##
##                                                                      ##
##                      EE                                              ##
##                                                                      ##
##                                                                      ##
##                                                                      ##
##  ##################################################################  ##
##                                                                      ##
##########################################################################
