##########################################################################
##::                                                                    ##
##  ##################################################################  ##
##  ##EE                                                            ##  ##
##  ##############################################################  ##  ##
##  ##                                                              ##  ##
##  ##############################################################  ##  ##
##  ##                                                              ##  ##
##  ##############################################################  ##  ##
##  ##                                                              ##  ##
##  ##############################################################  ##  ##
##  ##                                                              ##  ##
##  ##############################################################  ##  ##
##  ##                                                              ##  ##
##  ##############################################################  ##  ##
##                                                                      ##
##########################################################################
